NO ./textures/north.xpm
SO ./textures/south.xpm
EA ./textures/east.xpm
WE ./textures/west.xpm

F 123,111,99
C 222,200,111

111111
100001
10N001
111111